1111111111111111111111111111111111111111
1111111111111111111111111111111111111111
1111111111111111111111111111111111111111
1111000011001111110000001111100001110001
1111000011000000000001001111000000111001
1111000011000000000001000110000000001001
1111000000000111000000000000010001100001
1110000000010110001100000000010011110011
1100011100000000011111111000001001111111
1100111100000000111111111111001100111111
1111111100011111111110111111100110011111
1111111100111111111100001111110110011111
1111111111111111111110111111111111111111
1111111111111111111110111111111111111111
1111111111111111111111111111111111111111
1111111110000011000001111110010011100001
1111111111111111100001111110110011100001
1111111111111111110000111100000111000011
1110011111111111110000000000001111000011
1100001111111111100010000000001111100011
1100000111111110000100011000001111110011
1100110011111100011100111100000111110011
1100111001111100111100111100000111110011
1100011000111101110100111110001111110011
1110000000011000000000111111111111110011
1111100010000000011100011111111111100011
1111110000000000111110000000000000000011
1111111000000111111111000000000000000111
1111111111111111111111111111111111111111
1111111111111111111111111111111111111111